This is a list of newspapers in Iowa.
Ames Tribune – Ames
Atlantic News-Telegraph – Atlantic
Boone News-Republican – Boone
Carroll Daily Times Herald – Carroll
Cedar Rapids Defender – Cedar Rapids (currently unavailable)
Charles City Press – Charles City
Cherokee Chronicle Times – Cherokee
Clinton Herald – Clinton
Council Bluffs Daily Nonpareil – Council Bluffs
Creston News Advertiser – Creston
Daily Iowegian – Centerville
Des Moines Register – Des Moines
Estherville Daily News – Estherville
Fort Madison Daily Democrat – Fort Madison
The Gazette – Cedar Rapids
Globe Gazette – Mason City
The Hawk Eye – Burlington
Iowa City Press-Citizen – Iowa City
Keokuk Daily Gate City – Keokuk
Le Mars Daily Sentinel – Le Mars
Marshalltown Times Republican – Marshalltown
The Messenger – Fort Dodge
Mount Pleasant Southeast Iowa Union – Mount Pleasant (was formerly the Fairfield Daily Ledger, Mount Pleasant News and the Washington Evening Journal)
Muscatine Journal – Muscatine
Newton Daily News – Newton
Oelwein Daily Register – Oelwein
The Oskaloosa Herald – Oskaloosa
Ottumwa Courier – Ottumwa
Quad-City Times – Davenport
Sioux City Journal – Sioux City
Spencer Daily Reporter – Spencer
Telegraph Herald – Dubuque
The Valley News – Shenandoah
Vinton Cedar Valley Daily Times – Vinton
The Waterloo-Cedar Falls Courier – Waterloo
Webster City Daily Freeman-Journal – Webster CityThe Daily Iowan – Iowa City
The Grand Views – Des Moines
Iowa State Daily – Ames
The Northern Iowan – Cedar Falls
The Scarlet & Black – GrinnellDes Moines Business Record – Des Moines
Iowa Farm Bureau Spokesman – Iowa Falls
Iowa Farmer Today – Cedar Rapids
Quad-City Business Journal – DavenportAdair County Free Press – Greenfield
Adair News – Adair
Fontanelle Observer – GreenfieldAdams County Free Press – CorningAllamakee Journal – Lansing
Postville Herald – Postville
Waukon Standard – WaukonMoravia Union – Moravia
Moulton Tribune – MoultonAudubon County Advocate Journal – AudubonStar Press-Union – Belle Plaine
Vinton Eagle / Cedar Valley Times – VintonHudson Herald – Hudson
The Progress-Review – La Porte CityMadrid Register-News – Madrid
Ogden Reporter – OgdenSumner Gazette – Sumner
Tripoli Leader – Tripoli
Waverly Democrat – WaverlyIndependence Bulletin-Journal – Independence
Jesup Citizen Herald – Jesup
Lamont Leader – Lamont
The Winthrop News – WinthropBuena Vista County Journal – Newell, Iowa
Storm Lake Pilot-Tribune – Storm Lake
Storm Lake Times – Storm LakeButler County Tribune-Journal – Allison
Clarksville Star – ClarksvilleCalhoun County Journal – Manson
Lake City Graphic-Advocate – Lake CityBreda News – Breda
Coon Rapids Enterprise – Coon Rapids
Glidden Graphic – Glidden
Manning Monitor – ManningAnita Tribune – Anita
Griswold American – GriswoldLowden Sun-News and Advertiser – Lowden
Tipton Conservative – Tipton
West Branch Times – West BranchMirror Reporter – Clear Lake
Pioneer Enterprise – RockwellAurelia Star – Aurelia
Cherokee Chronicle Times – CherokeeFredericksburg News – Fredericksburg
Nashua Reporter – Nashua
New Hampton Economist-Tribune – New HamptonSentinel Tribune – OsceolaEverly-Royal News – Everly
Peterson Patriot – Peterson
Sioux Rapids Bulletin-Press – Sioux RapidsClayton County Register – Elkader
Guttenberg Press – Guttenberg
Monona Outlook – Monona
North Iowa Times – McGregor
Strawberry Point Press-Journal – Strawberry PointThe Observer – De WittCharter Oak-Ute Newspaper – Charter Oak
Denison Bulletin-Review – Denison
Manilla Times – Manilla
Schleswig Leader – Schleswig
Westside Observer – WestsideDallas County News – Adel
Northeast Dallas County Record – Woodward
Perry Chief – PerryBloomfield Democrat – BloomfieldLamoni Chronicle – Lamoni
Leon Journal-Reporter – LeonDelaware County Leader – Hopkinton
Edgewood Reminder – Edgewood
Manchester Press – ManchesterBurlington Beacon - Burlington
Des Moines County News – West Burlington
Mediapolis News – MediapolisDickinson County News – Spirit LakeCascade Pioneer – Cascade
Dyersville Commercial – DyersvilleArmstrong Journal – Armstrong
Ringsted Dispatch – ArmstrongElgin Echo – Elgin
Fayette County Union – West Union
Fayette Leader – Fayette
Hawkeye Booster – HawkeyeRockford Register – Nora SpringsConservative Chronicle – Hampton
Hampton Chronicle – Hampton
Sheffield Press - SheffieldArgus-Herald – Sidney
Beacon-Enterprise – Tabor
Hamburg Reporter – HamburgJefferson Herald – Jefferson
Scranton Journal – ScrantonThe Grundy Register – Grundy Center
The Record – Conrad
Reinbeck Courier – ReinbeckBayard News Gazette – Bayard
Guthrie Center Times – Guthrie Center
Guthrie County Vedette – Panora
Stuart Herald – StuartSouth Hamilton Record-News – Jewell
Stratford Courier – StratfordBritt News-Tribune – Forest City
The Leader – GarnerAckley World Journal – Ackley
Eldora Herald-Ledger – Eldora
Hardin County Index – Eldora
Iowa Falls Times Citizen – Iowa Falls
South Hardin Signal-Review – HubbardDunlap Reporter – Dunlap
Missouri Valley Times-News – Missouri Valley
Twiner-Herald – Woodbine and LoganNew London Journal – New London
Winfield Beacon/Wayland News – WinfieldCresco Times-Plain Dealer – Cresco
Lime Springs Herald – Lime Springs
Riceville Recorder – RicevilleHumboldt Independent – HumboldtIda County Courier – Ida GroveHometown Current – Marengo (consolidation and rebranding of the former North English English Valleys Star and Victor Warrior Tribune newspapers in June 2019)
Marengo Pioneer-Republican – Marengo
Williamsburg Journal Tribune – WilliamsburgBellevue Herald-Leader – Bellevue
Maquoketa Sentinel-Press Maquoketa
Preston Times – PrestonColfax Jasper Co. Tribune – Colfax
Monroe Legacy – Monroe
Prairie City News – Prairie City
Sully Hometown Press – SullyPackwood Clarion-Plainsman – RichlandLone Tree Reporter – Lone Tree
North Liberty Leader – North Liberty
Solon Economist – SolonAnamosa Journal-Eureka – Anamosa
Midland Times – Wyoming
Monticello Express – MonticelloKeota Eagle – Keota
Sigourney News-Review – Sigourney
What Cheer Patriot Chronical – What CheerBancroft Register – Bancroft
Swea City Herald-Press – Swea City
Titonka Topic – Titonka
Upper Des Moines – Algona
Whittemore Independent – WhittemoreWest Point Bee-Star – West PointLinn News-Letter – Central City
Marion Times – Marion
Mount Vernon-Lisbon Sun – Mount VernonColumbus Junction Gazette – Columbus Junction
Morning Sun News-Herald – Morning Sun
Wapello Republican – WapelloChariton Herald-Patriot – Chariton
Chariton Leader – CharitonDoon Press – Doon
The Free Lance – Little Rock
Lyon County News – George
Lyon County Reporter – Rock Rapids
West Lyon Herald – InwoodEarlham Advocate – Earlham
Winterset Madisonian – Winterset
Earlham Echo – EarlhamFremont Village Vine – Fremont
Oskaloosa Herald – OskaloosaKnoxville Journal-Express – Knoxville
Marion County News – PleasantvilleMid Iowa Enterprise – – State CenterGlenwood Opinion Tribune – Glenwood
Malvern Leader – MalvernMitchell County Press-News – Osage
Saint Ansgar Enterprise Journal – Saint Ansgar
Stacyville Monitor Review – StacyvilleMapleton Press – Mapleton
Onawa Democrat – Onawa
Onana Sentinel – OnawaAlbia Union-Republican – Albia
Monroe County News – AlbiaRed Oak Express – Red Oak
Villisca Review and Stanton Viking – VilliscaDiscover Muscatine – Muscatine
West Liberty Index – West Liberty
Wilton-Durant Advocate News – WiltonHartley Sentinel-News – Hartley
The N'West Iowa Review / Sheldon Mail-Sun – Sheldon
The O'Brien County Bell – Primghar
The Paullina Times – Paullina
Sanborn Pioneer – SanbornMelvin News – Melvin
Ocheyedan Press – Ocheyedan
Sibley Gazette-Tribune – SibleyClarinda Herald-Journal – Clarinda
Essex Independent – Essex
Shenandoah Valley News – ShenandoahEmmetsburg Democrat / Emmetsburg Reporter – Emmetsburg
Graettinger Times – Graettinger
Ruthven Zipcode – Ruthven
West Bend Journal – West BendAkron Hometowner – Akron
Hinton Times – Hinton
Kingsley News-Times – Kingsley
Remsen Bell-Enterprise – RemsenLaurens Sun – Laurens
Pocahontas Record Democrat – PocahontasAltoona Herald-Mitchellville Index – Altoona
Cityview – Johnston
Iowa Bystander – Des MoinesAvoca Journal-Herald – AvocaGrinnell Herald-Register – Grinnell
Poweshiek County Chronicle-Republican – Grinnell
Montezuma Record - MontezumaDiagonal Progress – Diagonal
Mount Ayr Record-News – Mount AyrOdebolt Chronicle – Odebolt
The Resort – Lake View
The Sun – Sac CityBettendorf News – Bettendorf
The Catholic Messenger – Davenport
The North Scott Press – EldridgeHarlan Tribune & News Advertiser – HarlanHawarden Independent – Hawarden
Ireton Examiner – Ireton
Rock Valley Bee – Rock Valley
Sioux Center News – Sioux Center
Sioux County Capital Democrat – Orange City
Sioux County Index Reporter – Hull
Siouxland Press – HospersNevada Journal – Nevada
Story City Herald – Story City
Tri-County Times – SlaterDysart Reporter – Dysart
Northern-Sun Print – Gladbrook
Tama News-Herald – Tama
Toledo Chronicle – Tama
Traer Star-Clipper – TraerBedford Times-Press – Bedford
Lenox Time Table – LenoxStar Enterprise – AftonVan Buren County Leader-Record Farmington
Van Buren County Register KeosauquaCarlisle Citizen – Carlisle
Indianola Independent Advocate – Indianola
Indianola Record-Herald & Tribune – Indianola
North Warren Town & County News – NorwalkKalona News – Kalona
Riverside Current – Riverside
Washington Evening Journal – Washington
Wellman Advance – WellmanCorydon Times-Republican – Corydon
Seymour Herald – SeymourDayton Leader – Dayton
Gowrie News – GowrieBuffalo Center Tribune – Buffalo Center
Thompson Courier and Rake Register – ThompsonCalmar Courier – Calmar
Decorah Journal-Public Opinion – Decorah
Ossian Bee – OssianDanbury Review – Danbury
Moville Record – Moville
Sergeant Bluff Advocate – Sergeant Bluff
Sioux Valley News – AnthonNorthwood Anchor NorthwoodBelmond Independent – Belmond
Eagle Grove Eagle – Eagle Grove
Wright County Monitor – ClarionDecorah Posten
Des Moines Tribune



Comprehensive
Lists of newspapers
List of newspapers in the United States
Frequency
List of free daily newspapers in the United States
List of weekly newspapers in the United States
Circulation
List of international newspapers originating in the United States
List of national newspapers in the United States
List of newspapers in the United States by circulation
List of newspapers serving cities over 100,000 in the United States
Foreign language
List of French-language newspapers published in the United States
List of German-language newspapers published in the United States
List of Spanish-language newspapers published in the United States


Specialty
List of African-American newspapers in the United States
List of alternative weekly newspapers in the United States
List of business newspapers in the United States
List of family-owned newspapers in the United States
List of Jewish newspapers in the United States
List of LGBT periodicals in the United States
List of student newspapers in the United States
List of supermarket tabloids in the United States
List of underground press in the United States
Other
List of defunct newspapers of the United States


Iowa Newspaper Association
Penny Abernathy, "The Expanding News Desert: Iowa", Usnewsdeserts.com, University of North Carolina at Chapel Hill. (Survey of local news existence and ownership in 21st century)